1111111111111
1001000C000C1
1000011111001
1P0011E001001
1111111111111
